10111111111
10000000001
10000110001
10000110001
10000000001
11111111111